25 25
..####...............++++
..#&##...............++++
..#|#............*...++++
*..|...........*.....++++
...||||||||||........++++
.*.||||||||||....*....+++
...........||......*...++
.....*.....||.*..*.....++
..*...*..*.||..........++
...**..*...==..........++
........~~~==~~~*......++
~~~~~~~~~~~==~~~~~.......
~~~~~~~~~~.==.~~~~~~~~~~~
......*....||....~~~~~~~~
...*......*||............
........*..||..*.........
.....*.....||...*.*......
+++.....*..|||....*......
+++..*.**...||||.........
+++.........||||||||.....
+++...*..*....||||||||...
+++.......**......|||||..
++++...*............|||..
++++........*...*........
++++..*..................